ano,semestre,uf,pop_alfabetizada,pop_nao_alfabetizada,populacao_total,taxa_analfabetismo,variacao_taxa,indice_vulnerabilidade
2023,1,AL,431558,96872,528430,18.332,,18.332
2023,1,PI,512716,110921,623637,17.7861,,17.7861
2023,1,PB,671250,123134,794384,15.5006,,15.5006
2023,1,MA,1042535,188241,1230776,15.2945,,15.2945
2023,1,CE,1394663,246531,1641194,15.0214,,15.0214
2023,1,SE,377354,61709,439063,14.0547,,14.0547
2023,1,RN,572677,92546,665223,13.912,,13.912
2023,1,PE,1486310,225699,1712009,13.1833,,13.1833
2023,1,AC,121266,17753,139019,12.7702,,12.7702
2023,1,BA,2505628,353442,2859070,12.3621,,12.3621
2023,1,TO,237973,26172,264145,9.9082,,9.9082
2023,1,PA,1222125,130945,1353070,9.6776,,9.6776
2023,1,RO,293723,20846,314569,6.6268,,6.6268
2023,1,AP,68320,4681,73001,6.4122,,6.4122
2023,1,RR,106091,6929,113020,6.1308,,6.1308
2023,1,AM,692359,43813,736172,5.9515,,5.9515
2023,1,ES,751784,47079,798863,5.8933,,5.8933
2023,1,GO,1316006,82231,1398237,5.881,,5.881
2023,1,MG,4000157,239721,4239878,5.654,,5.654
2023,1,MT,652660,37921,690581,5.4912,,5.4912
2023,1,MS,462679,25767,488446,5.2753,,5.2753
2023,1,PR,2211384,97242,2308626,4.2121,,4.2121
2023,1,RJ,3136214,115775,3251989,3.5601,,3.5601
2023,1,DF,517172,19076,536248,3.5573,,3.5573
2023,1,RS,1951068,65179,2016247,3.2327,,3.2327
2023,1,SP,8753197,288387,9041584,3.1896,,3.1896
2023,1,SC,1512527,44714,1557241,2.8714,,2.8714
2023,2,PI,608605,112448,721053,15.595,-2.1911,26.5505
2023,2,CE,1586977,239361,1826338,13.1061,-1.9153,22.6826
2023,2,AL,517883,110112,627995,17.5339,-0.7981,21.5244
2023,2,TO,291889,26479,318368,8.3171,-1.5911,16.2726
2023,2,AC,132504,18703,151207,12.3691,-0.4011,14.3746
2023,2,SE,424618,69422,494040,14.0519,-0.0028,14.0659
2023,2,BA,2412328,335125,2747453,12.1977,-0.1644,13.0197
2023,2,MA,1010562,193423,1203985,16.0652,0.7707,12.2117
2023,2,PE,1548090,240556,1788646,13.4491,0.2658,12.1201
2023,2,RO,317934,18625,336559,5.5339,-1.0929,10.9984
2023,2,PA,1258775,130260,1389035,9.3777,-0.2999,10.8772
2023,2,RN,513035,90508,603543,14.9961,1.0841,9.5756
2023,2,PB,574998,117953,692951,17.0218,1.5212,9.4158
2023,2,GO,1299505,71105,1370610,5.1878,-0.6932,8.6538
2023,2,DF,445958,10961,456919,2.3989,-1.1584,8.1909
2023,2,MS,606444,29966,636410,4.7086,-0.5667,7.5421
2023,2,ES,780668,46614,827282,5.6346,-0.2587,6.9281
2023,2,RJ,3558082,115596,3673678,3.1466,-0.4135,5.2141
2023,2,MT,692374,41421,733795,5.6448,0.1536,4.8768
2023,2,RR,141351,9898,151249,6.5442,0.4134,4.4772
2023,2,RS,2300734,69867,2370601,2.9472,-0.2855,4.3747
2023,2,SP,8915474,275588,9191062,2.9984,-0.1912,3.9544
2023,2,AP,69895,5293,75188,7.0397,0.6275,3.9022
2023,2,MG,3780042,247424,4027466,6.1434,0.4894,3.6964
2023,2,PR,2256671,103245,2359916,4.3749,0.1628,3.5609
2023,2,SC,1471857,41431,1513288,2.7378,-0.1336,3.4058
2023,2,AM,515018,49594,564612,8.7837,2.8322,-5.3773
2024,1,PB,698410,129591,828001,15.6511,-1.3707,22.5046
2024,1,RN,616032,94483,710515,13.2978,-1.6983,21.7893
2024,1,AL,475767,97262,573029,16.9733,-0.5606,19.7763
2024,1,AM,907848,58674,966522,6.0706,-2.7131,19.6361
2024,1,MA,1045484,187548,1233032,15.2103,-0.8549,19.4848
2024,1,PA,1583368,141575,1724943,8.2075,-1.1702,14.0585
2024,1,SE,333848,57896,391744,14.779,0.7271,11.1435
2024,1,BA,2526149,365671,2891820,12.645,0.4473,10.4085
2024,1,AP,203983,13904,217887,6.3813,-0.6584,9.6733
2024,1,CE,1603451,264547,1867998,14.1621,1.056,8.8821
2024,1,AC,141726,21888,163614,13.3778,1.0087,8.3343
2024,1,PE,1438870,251668,1690538,14.8869,1.4378,7.6979
2024,1,MG,4001954,248391,4250345,5.844,-0.2994,7.341
2024,1,PI,502227,108909,611136,17.8207,2.2257,6.6922
2024,1,GO,1452434,76510,1528944,5.0041,-0.1837,5.9226
2024,1,ES,610756,36193,646949,5.5944,-0.0402,5.7954
2024,1,PR,2221791,95000,2316791,4.1005,-0.2744,5.4725
2024,1,TO,236307,24190,260497,9.2861,0.969,4.4411
2024,1,DF,581045,11789,592834,1.9886,-0.4103,4.0401
2024,1,SP,8873616,261511,9135127,2.8627,-0.1357,3.5412
2024,1,SC,1512765,39789,1552554,2.5628,-0.175,3.4378
2024,1,RR,77778,6320,84098,7.515,0.9708,2.661
2024,1,MT,671738,46712,718450,6.5018,0.857,2.2168
2024,1,RJ,3060838,107144,3167982,3.3821,0.2355,2.2046
2024,1,RS,2084316,70504,2154820,3.2719,0.3247,1.6484
2024,1,MS,468282,33531,501813,6.682,1.9734,-3.185
2024,1,RO,244252,20636,264888,7.7905,2.2566,-3.4925
2024,2,AC,139520,15490,155010,9.9929,-3.3849,26.9174
2024,2,PE,1728362,242972,1971334,12.3253,-2.5616,25.1333
2024,2,SE,364216,51377,415593,12.3623,-2.4167,24.4458
2024,2,MA,1260109,203078,1463187,13.8792,-1.3311,20.5347
2024,2,PI,519628,113761,633389,17.9607,0.14,17.2607
2024,2,PB,700613,131760,832373,15.8294,0.1783,14.9379
2024,2,RO,297573,19424,316997,6.1275,-1.663,14.4425
2024,2,CE,1419566,236716,1656282,14.292,0.1299,13.6425
2024,2,AL,563979,122469,686448,17.841,0.8677,13.5025
2024,2,MS,496902,26596,523498,5.0804,-1.6016,13.0884
2024,2,RN,579341,89381,668722,13.3659,0.0681,13.0254
2024,2,TO,289124,28294,317418,8.9138,-0.3723,10.7753
2024,2,BA,2413162,366661,2779823,13.1901,0.5451,10.4646
2024,2,MT,647633,38432,686065,5.6018,-0.9,10.1018
2024,2,PA,1527426,133817,1661243,8.0552,-0.1523,8.8167
2024,2,ES,775105,43955,819060,5.3665,-0.2279,6.506
2024,2,AP,158732,10764,169496,6.3506,-0.0307,6.5041
2024,2,MG,4064344,249420,4313764,5.782,-0.062,6.092
2024,2,RR,93416,8000,101416,7.8883,0.3733,6.0218
2024,2,RJ,3010580,94327,3104907,3.038,-0.3441,4.7585
2024,2,RS,2361352,73258,2434610,3.009,-0.2629,4.3235
2024,2,SC,1524656,39250,1563906,2.5097,-0.0531,2.7752
2024,2,PR,2160580,102840,2263420,4.5436,0.4431,2.3281
2024,2,GO,1248394,78846,1327240,5.9406,0.9365,1.2581
2024,2,SP,8758238,307881,9066119,3.396,0.5333,0.7295
2024,2,AM,551897,46886,598783,7.8302,1.7596,-0.9678
2024,2,DF,675612,21454,697066,3.0778,1.0892,-2.3682
